111111111111111111111111111111111111
11E000000000000000000000000000000001
100001010010000010100100000001010001
101001001010101000100100000001010001
1P00000000C0000000000000000000000001
111111111111111111111111111111111111
