111111111111111111111111111111111111
11E000000000000000000C0000000000C001
1000010100100000101C010000C001010001
101001001010101000100100000001010001
1P00000000C0000000000000C00000000001
111111111111111111111111111111111111
