1111111111111
10010000000C1
1000011111001
1E0011P000001
11111111111111
