1111111111111
10010000000C1
1000011111001
1E0011P000000
1111111111111
