1111111111
10100000C1
1000111101
1P011E0001
1111111111
