1111111111
1P110000C1
1010011111
1000C0C0E1
1111111111
