1111111111
1100010CE1
1C01P10001
11010001C1
1111111111
