111111111111111111111111111111111111
11E000000010000111100C0000001100C011
1000010000100000101C010000C001010001
111000000000101000000000000001000001
1000010100100000101C000000C000000001
101001001010101000100100000001011111
1P00010000C1111000100000C11100000C11
111111111111111111111111111111111111
