111111111111111111111111111111111111
1E00000000100C0001100C00010011010001
1000010100100001101C000001C001010001
10011100110010100010000000000000C001
1000C10000000000100C010000C001000001
110001101000001000100100000001010001
1110010000C00C0000110000C00011110P01
111111111111111111111111111111111111
